36 22
000000000000000000000000000000000000
000000000000000000000000000000000000
000000000000000000000000000000000000
000000000000000000000000000000000000
000000000000000000000000000000000000
000000000000000000000000000000000000
000000000000000001111111111000000000
000000000000000001111111111000000000
000000000000000001111111111000000000
000000000000000001111111111000000000
000000000000000000000111111000000000
000000000000000000000111111000000000
000000000000000000000111111000000000
000000000000000011111111111000000000
000000000000000011111111111000000000
000000000000000011111111111000000000
000000000000000000000000000000000000
000000000000000000000000000000000000
000000000000000000000000000000000000
000000000000000000000000000000000000
000000000000000000000000000000000000
000000000000000000000000000000000000
